Emitters emit lasers. Use components to redirect lasers into receivers.
1 0 0
BBBBBBBBBBBBBBBBBBBBBBBBBB
B                        B
B                        B
E                        B
B                        B
B                        B
BBBBBBBBBBBBaBBBBBBBBBBBBB