Prisms split laser beams, and lenses combine them.
0 1 1
BBBBBBaBBBBBBBBBBBGBBBBBBB
B          BB            B
B          BB            B
y          jE            z
B          BB            B
B          BB            B
BBBBBBfBBBBBBBBBBBJBBBBBBB