Level IV
9 1 1
BCKGBBBBBBBBBBBaBBBBBBBBBB
B   B                    B
B   B         B B        B
BB B          B B        B
BB BBBBBBBBBB B B        B
BB            f B        B
BBBBBBBBBBBBBBBBBBBjBBBBBB