Level I
6 0 0
BBBBBBBBBBBBBBBBBBBBBBBBBB
B     B                  B
E     B           B      B
B     B    BBBBjBBB      B
B                 B      B
M                 B      B
BBBBBBBBBBBBBBBBBBBBBaBBBB