Level II
3 0 0
BBBBBBSBBBBBBBBBBBBBOBBBBB
B          B r B         B
B                        B
B                        B
B                        B
B          B n B         B
BBBBBBBBBBBBBBBBBBBBBBBBBB