Level V
0 2 1
BwBBBBBBBBBBBBBBBBBBBBBBBB
f                        a
I                        z
B                        B
B                        D
B            V           B
BvBBBBBBBBBBBBBBBBBBBBBBBB