Level III: REPLACE ME!!!
1 0 0
BBBBBBBBBBBBBBBBBBBBBBBBBB
B                        B
B                        B
E                        B
B                    r   B
B                        B
BBBBBBBBBBBBBBBBBBBBBBBBBB