Level VII
12 3 3
BBBBBBBBBBBBBBBBaBBjBBfBBB
B                        B
y                        B
y                        B
y                        B
B                        B
BBBBBBBBBBBBBBBBrBBnBBvBBB