Level VI
6 1 1
BBBBBBBBBBBBBBBBBBBBBBBBBB
B                        B
B          BB BB         B
v          Q   L         f
B          BB BB         B
B                        B
BBBBBBBBBBBBBBBBBBBBBBBBBB