Prisms split laser beams, and lenses combine them.
0 1 1
BBBBBBBBBBBBBBBBBBGBBBBBBB
B     a    BB            B
B          BB            B
y         jBE           zB
B          BB            B
B     f    BB            B
BBBBBBBBBBBBBBBBBBJBBBBBBB