Level III
9 0 0
BBBBBBBBBBBBBBBBBBBCBBBBBB
v         B B            X
BBB BBBBB B B B B B BBBBBB
B             B B        B
B BBBBBBB BBBBB BBB B BBBB
B     B             B    B
BBBaBBBBBBBBBBBBBBBBBBBBBB