Level V
0 2 1
BBBBBBBBBBBBBBBBBBBBBBBBBB
BwBBBBBBBBBBBBBBBBBBBBBBBB
f                        a
I                        z
B                        D
B            V           B
BvBBBBBBBBBBBBBBBBBBBBBBBB